1111111111111111111111111111111111111111111111111111111111111111
1444444444444444444444444444444444444444444444444444444444111111
1444444444444444444444444444444444444444444444444444444444111111
1444444444444444444444444444444444444444444444444444444444111111
1444444444444444444444444444444444444444444444444444411111111111
1444444444444444444444444444444444444444444444444444411111111111
1444444442222222222222222244422222222222444444444444411111111111
1444444444444444444444444444444444444444444444444441111111111111
1444444444444444444444444444444444444444444444411111111111111111
1444444444444444444444444444444444444444444441111111111111111111
1444444444444444444444444444444444444444444441111111111111111111
1444444444444444444444444444444444444444444411111111111111111111
1111111111111111111111111114111111111111111111111111111111111111
1111111111111111111111111114111111111111111111111111111111111111
1111111111111111111111111114111111111111111111111111111111111111
1111111111111111111111111114111111111111111111111111111111111111
1111111111111111111111111114111111111111111111111111111111111111
1111111111111111111111111114111111111111111111111111111111111111
1111111111111111111111111114111111111111111111111111111111111111
1111111111111111111111111114111111111111111111111111111111111111
1111111111111111111111111114111111111111111111111111111111111111
1111111111111111111111111114111111111111111111111111111111111111
1111111111111111111111111114111111111111111111111111111111111111
1111111111111111111111111114111111111111111111111111111111111111
1111111111111111111111111114111111111111111111111111111111111111
1111111111111111111111111114111111111111111111111111111111111111
1111111111111111111111111114111111111111111111111111111111111111
1111111111111111111111111114111111111111111111111111111111111111
1111111111111111111111111114111111111111111111111111111111111111
1111111111111111111111111114111111111111111111111111111111111111
1111111111111111111111111114444444444444444444444111111111111111
1111111111111111111111111144411111111111111111114111111111111111
1111111111111111111111111144411111111111111111114111111111111111
1111111111111111111111111144411111111111111111114444444441111111
1114111111111111111111111144411111111111111111111111111141111111
1114111111111111111111111144411111111111111111111111111141111111
1114111111111111111111111144411111111111111111111111111144111111
1114111111111111111111111144411111111111111111111111111114111111
1114444444444444444444444444444444444444444444444444444444111111
1114411111111111111111111144411111111111111111111111111114111111
1114411111111111111111111144411111111111111111111111111114111111
1111411111111111111111111144411111111111111111111111111114111111
1111411111111111111111111144444444444444444444444444444444444111
1111444444444444444444444444411111111111111111111111111111114111
1111411111111111111111111144411111111111111111111111111111111111
1111411111111111111111111144411111111111111111111111111111111111
1111411111111111111111111144411111111111111111111111111111111111
1111411111111111111111111114111111111111111111111111111111111111
1111411111111111111111111114111111111111111111111111111111111111
1111411111111111111111111114111111111111111111111111111111111111
1111411111111111111111111114111111111111111111111111111111111111
1111411111111111111111111114111111111111111111111111111111111111
1111444444444444444444444444444444444444444444444444441111111111
1111111111111111111111111111411111111111111111111111141111111111
1111111111111111111111111111411111111111111111111111141111111111
1111111111111111111111111111411111111111111111111111141111111111
1111111111111111111111111111411111111111111111111111141111111111
1111111111111111111111111111411111111111111111111111141111111111
1111111111111111111111114444411111111111111111111111141111111111
1111111111111111111111114111111111111111111111111111141111111111
1111111111111111111111114111111111111111111111111111141111111111
1111111111111111111111114444444444444444444444444444141111111111
1111111111111111111111111111111111111111111111111114141111111111
1111111444444444444444444444444444444444444444444444141111111111
1111111411111111111111111111111111111111111111111111141111111111
1111111411111111111111111111111111111111111111111111141111111111
1111111444444444444444444444444444444444444444111111141111111111
1111111111111111111111111111111111111111111114111111141111111111
1111111111111111111111111111111111111111111114111111141111111111
1111111112121212121212121212121212121212121214111111141111111111
1111111444444444444444444444444444444444444444111111141111111111
1111111411111111111111111111111111111111111111111111144444441111
1111111411111111111111111111111111111111111111111111111111141111
1111111444444444444444444444444444444444444444444441111111141111
1111111111111111111111111111111111111111111111111141111111141111
1111444444444444444444444444444444444444444444444444444444141111
1111411111111111111111111111111111111111111111111111111114141111
1111411114444444444444444444444444444444444444441111111114141111
1111411114111111111111111111111111111111111111141111111114141111
1111411114114444444444444444444444444444444444441111111114141111
1111411114114111111111111111111111111111111111111111111114141111
1111411114114444444444444443124444444444444444444444444444141111
1111411114111111111111111111111111111111111111111111111111141111
1111411114111111111111111111111111111111111111111111111111141111
1111411114444444444444444444444444444444444444444444444444441111
1111411111111111111111111111111111111111111111111111111111111111
1111411111111111111111111111111111111111111111111111111111111111
1111411111111111111111111111111111111111111111111111111111111111
1111411111114444444444444444444444421111111111111111111111111111
1111411111114111111111111111111111111111111111111111111111111111
1111444444444444444444444444444444444444444444444411111111111111
1111111111114111111111111111111111111111111111111111111111111111
1111111111114444444444444444444444421111111111111111111111111111
1111111111111111111111111111111111111111111111111111111111111111
1111111111111111111111111111111111111111111111111111111111111111
1111111111111111111111111111111111111111111111111111111111111111
1111111111111111111111111111111111111111111111111111111111111111
1111111111111111111111111111111111111111111111111111111111111111