0404040404040404040404040404040404040404040404040404040404040404
4111111111111111111111111111111111111111111111111111111111110404
4111111111111111111111111111111111111111111111111111111111110404
4111040404040404040404040404040404040404040404040404040404040404
4111040404040404040404040404040404040404022222222222222222240404
4111040404040404040404040404040404040404220404040404040404040404
4111040404040404040404040404040404040402240404040404040404040404
4111222222222222222222222222222222222222040404040404040404040404
4111040404040404040404040404040404040224040404040404040404040404
4111040404040404040404040404040404042204040404040404040404040404
4111040404040404062222222222222222222404040404040404040404040404
4111040404040404040404040404040404040404040404040404040404040404
4111040404040404040404040404040404040404040404040404040404040404
4111111111111111111111111111111111111111111111111111111111111114
4111111111111111111111111111111111111111111111111111111111111114
4111111111111111111111140404040404040404040404040404040404040404
4111111111111111111111111404040404040404040404040404040404040404
4111111111111111111111111111111104040404040404040404040404040404
4040404040404041111111111111111104040404040404040404040404040404
4040404040404011111111111111111104040404040404040404040404040404
4040404040404011111111111111111104040404040404040404040404040404
4040404040401111111111111111111114040404040404040404040404040404
4040404040401111111111111111111114040404040404040404040404040404
4040404040401111111111111111111111111111111104040404040404040404
4040404040404011111111111111111111111404040404040404040404040404
4040404040404040111111111111111111110404040404040404040404040404
4040404040404040404042222222222222220404040404040404040404040404
4040404040404040404040404222220404040404040404040404040404040404
4040404040404040404040404222220404040404040404040404040404040404
4040404040404040404040404022240404040404040404040404040404040404
4040404040404040404040404022222222222222222222222404040404040404
4040404040404040404040404022240404040404040404042404040404040404
4040404040404040404040404022240404040404040404042404040404040404
4045404040404040404040404022240404040404040404042222222224040404
4042404010404040404040404022240404040404040404040404040424040404
4042401111104040404040404022240404040404040404040404040424040404
4042404010404040404040404022240404040404040404040404040422040404
4042404040404040404040404022240404040404040404040404040402040404
4042222222222222222222222222222222222222222222222222222222040404
4042222040404040404040404022240404040404040404040404040402040404
4042222040404040404040404022240404040404040404040404040402040404
4040204040404040404040404022240404040404040404040404040402040404
4040404040404040404040404022222222222222222222222222222222222404
4040222222222222222222222222240404040404040404040404040404042404
4040204040404040404040404022240404040404040404040404040404040404
4040204040404040404040404022240404040404040404040404040404040404
4040204040404040404040404022240404040404040404040404040404040404
4040204040404040404040404042040404040404040404040404040404040404
4040204040404040404040404042040404040404040404040404040404040404
4040204040404040404040404041040404040404040404040404040404040404
4040204040404040404040404041040404040404040404040404040404040404
4040404040404040404040404041040404040404040404040404040404040404
4040111111111111111111111111111111111111111111111111111111040404
4040104040404040404040404011110404040404040404040404040404040404
4040104040404040404040404011110404040404040404040404040404040404
4040104040404040404040404111111040404040404040404040404040404044
4040104040404040404040401111111104040404040404040404040404040404
4040104040404040404040401111111104040404040404040404040404040404
4040104040404040404040401111111104040404040404040404040404040404
4040104040404040404040401111111104040404040404040404040404040404
4040104040404040404040401111111104040404040404040404040404040404
4040104040404040404040401111111104040404040404040404040404040404
4040104040404040404040401111111104040404040404040404040404040404
4040104040404040404040401111111104040404040404040404040404040404
4040104040404040404040401111111104040404040404040404040404040404
4040104040404040404040401111111104040404040404040404040404040404
4040104040404040404040401111111104040404040404040404040404040404
4040104040404040404040404047040404040404040404040404040404040404
4040104040404040404040404040404040404040404040404040404040404044
4040111111111111111111111111111111111111111111113040404040404044
4040404040404040404040404040404040404040404040404040404040404044
4040404040404040404040404040404040404040404040404040404040404044
4040404040404040404040404040404040404040404040404040404040404044
4040404040404040404040404040404040404040404040404040404040404044
4040404040404040404040404040404040404040404040404040404040404044
4040404040404040404040404040404040404040404040404040404040404044
4040404040404040404040404040404040404040404040404040404040404044